"ap" = (/obj/machinery/computer/operating{dir = 4},/obj/effect/turf_decal/tile/blue{dir = 8},/obj/effect/turf_decal/tile/blue{dir = 4},/turf/open/floor/plasteel/white,/area/space)
"at" = (/obj/structure/table,/obj/item/storage/backpack/duffelbag/med/surgery,/obj/effect/turf_decal/tile/blue{dir = 8},/obj/effect/turf_decal/tile/blue{dir = 4},/turf/open/floor/plasteel/white,/area/space)
"av" = (/obj/structure/table,/obj/machinery/chem_dispenser/drinks,/turf/open/floor/plasteel/cafeteria{dir = 5},/area/space)
"aD" = (/obj/machinery/door/airlock{id_tag = "Dorm4"; name = "Dorm 4"},/obj/machinery/door/firedoor/border_only{dir = 4},/obj/machinery/door/firedoor/border_only{dir = 8},/turf/open/floor/wood,/area/space)
"aQ" = (/obj/effect/spawner/structure/window/reinforced,/obj/structure/grille,/turf/open/floor/plasteel/white,/area/space)
"dc" = (/obj/machinery/door/firedoor/border_only{dir = 4},/obj/machinery/door/firedoor/border_only{dir = 8},/turf/open/floor/plasteel/white,/area/space)
"dY" = (/turf/open/floor/plasteel,/area/space)
"eA" = (/obj/machinery/light,/turf/open/floor/plasteel/white,/area/space)
"eR" = (/obj/machinery/light{dir = 8},/turf/open/floor/plasteel/dark,/area/space)
"fe" = (/obj/machinery/door/airlock{name = "Kitchen"; req_access_txt = "0"},/obj/machinery/door/firedoor/border_only{dir = 1},/obj/machinery/door/firedoor/border_only,/turf/open/floor/plasteel/cafeteria{dir = 5},/area/space)
"fE" = (/obj/machinery/door/airlock/medical/glass{name = "Medbay Treatment"; req_access_txt = "0"},/obj/effect/turf_decal/tile/blue{dir = 8},/obj/effect/turf_decal/tile/blue{dir = 4},/obj/machinery/door/firedoor/border_only{dir = 1},/obj/machinery/door/firedoor/border_only,/turf/open/floor/plasteel/white,/area/space)
"gH" = (/obj/machinery/suit_storage_unit/standard_unit{suit_type = /obj/item/clothing/suit/space/paramedic},/turf/open/floor/plasteel,/area/space)
"hR" = (/obj/effect/turf_decal/tile/blue{dir = 8},/obj/effect/turf_decal/tile/blue{dir = 4},/turf/closed/wall,/area/space)
"je" = (/obj/machinery/vending/boozeomat,/turf/open/floor/plasteel/cafeteria{dir = 5},/area/space)
"jg" = (/obj/structure/grille,/obj/effect/spawner/structure/window/reinforced,/turf/open/floor/plasteel/cafeteria{dir = 5},/area/space)
"jl" = (/obj/structure/table,/obj/item/plate{pixel_x = -7; pixel_y = 7},/turf/open/floor/plasteel/white,/area/space)
"jp" = (/obj/machinery/vending/dinnerware,/turf/open/floor/plasteel/cafeteria{dir = 5},/area/space)
"jV" = (/obj/structure/table,/obj/item/reagent_containers/glass/mixbowl{pixel_x = 1; pixel_y = 4},/obj/item/kitchen/rollingpin,/turf/open/floor/plasteel/cafeteria{dir = 5},/area/space)
"ky" = (/obj/effect/spawner/structure/window/reinforced/shutter,/obj/structure/grille,/turf/open/floor/plasteel/dark,/area/space)
"kZ" = (/obj/structure/closet/emcloset,/turf/open/floor/plasteel,/area/space)
"lc" = (/obj/structure/shuttle/engine/heater{dir = 4},/obj/structure/window/reinforced{dir = 8},/turf/open/space/basic,/area/space)
"lR" = (/obj/machinery/light{dir = 8},/turf/open/floor/plasteel/white,/area/space)
"lZ" = (/obj/machinery/light{dir = 4},/turf/open/floor/wood,/area/space)
"mb" = (/obj/structure/rack,/obj/item/storage/toolbox/electrical{pixel_x = -5; pixel_y = -7},/obj/item/pipe_dispenser,/turf/open/floor/plasteel,/area/space)
"mC" = (/obj/machinery/light{dir = 8},/turf/open/floor/wood,/area/space)
"nJ" = (/obj/structure/table/optable,/obj/effect/turf_decal/tile/blue{dir = 8},/obj/effect/turf_decal/tile/blue{dir = 4},/turf/open/floor/plasteel/white,/area/space)
"oj" = (/turf/open/floor/wood,/area/space)
"rR" = (/turf/open/floor/plasteel/white,/area/space)
"sm" = (/turf/open/floor/plating,/area/space)
"sA" = (/obj/structure/table,/obj/machinery/chem_dispenser/drinks/beer,/turf/open/floor/plasteel/cafeteria{dir = 5},/area/space)
"uB" = (/obj/machinery/light{dir = 4},/turf/open/floor/plasteel/white,/area/space)
"uN" = (/obj/structure/closet/firecloset,/turf/open/floor/plasteel,/area/space)
"uR" = (/obj/structure/reagent_dispensers/watertank/high,/turf/open/floor/plasteel,/area/space)
"vw" = (/obj/machinery/button/door{id = "Dorm2"; name = "Dorm Bolt Control"; normaldoorcontrol = 1; pixel_x = 27; specialfunctions = 4},/obj/machinery/light{dir = 4},/turf/open/floor/wood,/area/space)
"wP" = (/obj/machinery/light{dir = 4},/turf/open/floor/plasteel/dark,/area/space)
"xA" = (/obj/machinery/griddle,/turf/open/floor/plasteel/cafeteria{dir = 5},/area/space)
"xG" = (/obj/structure/table,/obj/machinery/reagentgrinder/kitchen{pixel_y = 8},/turf/open/floor/plasteel/cafeteria{dir = 5},/area/space)
"xH" = (/obj/machinery/door/airlock/external{name = "Port Docking Bay 1"},/obj/effect/mapping_helpers/airlock/cyclelink_helper{dir = 1},/turf/open/floor/plating,/area/space)
"xS" = (/obj/structure/rack,/obj/item/storage/toolbox/mechanical/insulateds{pixel_x = -6; pixel_y = -6},/obj/item/storage/toolbox/emergency{pixel_x = 2; pixel_y = 5},/turf/open/floor/plasteel,/area/space)
"yz" = (/obj/machinery/light{dir = 1},/turf/open/floor/plasteel/white,/area/space)
"zp" = (/obj/structure/reagent_dispensers/fueltank,/turf/open/floor/plasteel,/area/space)
"Ac" = (/obj/structure/chair/stool{pixel_y = 8},/turf/open/floor/plasteel/white,/area/space)
"Ah" = (/obj/machinery/door/airlock{id_tag = "Dorm2"; name = "Dorm 2"},/obj/machinery/door/firedoor/border_only{dir = 4},/obj/machinery/door/firedoor/border_only{dir = 8},/turf/open/floor/wood,/area/space)
"Au" = (/obj/structure/closet/secure_closet/medical2,/obj/effect/turf_decal/tile/blue{dir = 8},/obj/effect/turf_decal/tile/blue{dir = 4},/turf/open/floor/plasteel/white,/area/space)
"By" = (/obj/machinery/sleeper,/obj/effect/turf_decal/tile/blue{dir = 8},/obj/effect/turf_decal/tile/blue{dir = 4},/turf/open/floor/plasteel/white,/area/space)
"Dl" = (/obj/structure/table,/obj/item/storage/box/donkpockets,/turf/open/floor/plasteel/cafeteria{dir = 5},/area/space)
"DO" = (/obj/effect/turf_decal/tile/blue{dir = 8},/obj/effect/turf_decal/tile/blue{dir = 4},/turf/open/floor/plasteel/white,/area/space)
"EK" = (/turf/closed/wall,/area/space)
"EL" = (/obj/machinery/door/airlock/hatch{name = "Cockpit"; req_access_txt = "0"},/obj/machinery/door/firedoor/border_only{dir = 4},/obj/machinery/door/firedoor/border_only{dir = 8},/turf/open/floor/plasteel/dark,/area/space)
"EN" = (/obj/machinery/light,/turf/open/floor/wood,/area/space)
"ET" = (/obj/machinery/door/firedoor/border_only{dir = 8},/obj/machinery/door/firedoor/border_only{dir = 4},/turf/open/floor/plasteel,/area/space)
"Fa" = (/obj/structure/tank_dispenser/oxygen,/turf/open/floor/plasteel,/area/space)
"Gh" = (/obj/effect/spawner/structure/window/reinforced,/obj/structure/grille,/turf/open/floor/plasteel,/area/space)
"GG" = (/obj/structure/rack,/obj/item/construction/rcd{pixel_x = -3; pixel_y = -5},/obj/item/construction/rcd{pixel_x = 5; pixel_y = 6},/turf/open/floor/plasteel,/area/space)
"GL" = (/obj/effect/spawner/structure/window/reinforced/shutter,/obj/machinery/door/firedoor/border_only{dir = 4},/obj/machinery/door/firedoor/border_only{dir = 8},/obj/structure/grille,/turf/open/floor/plasteel/dark,/area/space)
"ID" = (/turf/open/floor/plasteel/cafeteria{dir = 5},/area/space)
"IM" = (/obj/machinery/portable_atmospherics/canister/oxygen,/turf/open/floor/plasteel,/area/space)
"JO" = (/turf/closed/wall/mineral/titanium,/area/space)
"Kf" = (/obj/machinery/light{dir = 4},/turf/open/floor/plasteel,/area/space)
"Lm" = (/obj/machinery/door/airlock/hatch{name = "Cockpit"; req_access_txt = "0"},/obj/machinery/door/firedoor/border_only{dir = 8},/obj/machinery/door/firedoor/border_only{dir = 4},/turf/open/floor/plasteel/dark,/area/space)
"Mn" = (/obj/structure/shuttle/engine/propulsion/right{dir = 4},/turf/open/space/basic,/area/space)
"Mo" = (/obj/machinery/door/airlock{id_tag = "Dorm3"; name = "Dorm 3"},/obj/machinery/door/firedoor/border_only{dir = 4},/obj/machinery/door/firedoor/border_only{dir = 8},/turf/open/floor/wood,/area/space)
"MP" = (/obj/structure/table,/turf/open/floor/plasteel/white,/area/space)
"Nc" = (/obj/machinery/button/door{id = "Dorm2"; name = "Dorm Bolt Control"; normaldoorcontrol = 1; pixel_x = 28; pixel_y = -1; specialfunctions = 4},/obj/machinery/light{dir = 4},/turf/open/floor/wood,/area/space)
"NI" = (/obj/structure/table,/obj/item/plate{pixel_x = 1; pixel_y = 4},/turf/open/floor/plasteel/white,/area/space)
"Ok" = (/obj/effect/spawner/structure/window/reinforced,/obj/effect/turf_decal/tile/blue{dir = 8},/obj/effect/turf_decal/tile/blue{dir = 4},/obj/machinery/door/firedoor/border_only{dir = 1},/obj/machinery/door/firedoor/border_only,/obj/structure/grille,/turf/open/floor/plasteel/white,/area/space)
"OC" = (/obj/machinery/door/airlock/external{name = "Port Docking Bay 1"},/obj/effect/mapping_helpers/airlock/cyclelink_helper,/turf/open/floor/plating,/area/space)
"ON" = (/turf/open/space/basic,/area/space)
"Qm" = (/obj/structure/table,/obj/item/book/manual/wiki/cooking_to_serve_man,/turf/open/floor/plasteel/cafeteria{dir = 5},/area/space)
"Si" = (/turf/open/floor/plasteel/dark,/area/space)
"SF" = (/obj/structure/table/reinforced,/obj/machinery/door/firedoor/border_only{dir = 1},/obj/machinery/door/firedoor/border_only,/turf/open/floor/plasteel/cafeteria{dir = 5},/area/space)
"TJ" = (/obj/machinery/button/door{id = "Dorm2"; name = "Dorm Bolt Control"; normaldoorcontrol = 1; pixel_x = -25; specialfunctions = 4},/obj/machinery/light{dir = 8},/turf/open/floor/wood,/area/space)
"Wj" = (/obj/machinery/door/airlock/public/glass{name = "Dormitory"},/obj/machinery/door/firedoor/border_only,/obj/machinery/door/firedoor/border_only{dir = 1},/turf/open/floor/wood,/area/space)
"Ws" = (/obj/machinery/deepfryer,/turf/open/floor/plasteel/cafeteria{dir = 5},/area/space)
"WH" = (/obj/structure/table,/obj/item/reagent_containers/food/drinks/shaker,/turf/open/floor/plasteel/cafeteria{dir = 5},/area/space)
"WI" = (/obj/structure/closet/crate/freezer/blood,/obj/effect/turf_decal/tile/blue{dir = 8},/obj/effect/turf_decal/tile/blue{dir = 4},/turf/open/floor/plasteel/white,/area/space)
"Xb" = (/obj/machinery/door/airlock{id_tag = "Dorm1"; name = "Dorm 1"},/obj/machinery/door/firedoor/border_only{dir = 4},/obj/machinery/door/firedoor/border_only{dir = 8},/turf/open/floor/wood,/area/space)
"YH" = (/obj/machinery/iv_drip,/obj/effect/turf_decal/tile/blue{dir = 8},/obj/effect/turf_decal/tile/blue{dir = 4},/turf/open/floor/plasteel/white,/area/space)
"Zm" = (/obj/structure/closet/secure_closet/freezer/fridge,/turf/open/floor/plasteel/cafeteria{dir = 5},/area/space)

(1,1,1) = {"
ONONONONONONONONONONONONONONONONONONONONONONONONONONONONONONONONONONONONONONONONONONONONONONONONONONONONONONONONONONONON
ONONONONONONONONONONONONONONONONONONONONONONONONONONONONONONONONONONONONONONONONONONONONONONONONONONONONONONONONONONONON
ONONONONONONONONONONONONONONONONONONONONONONONONONONONONONONONONONONONONONONONONONONONONONONONONONONONONONONONONONONONON
ONONONONONONONONONONONONONONONONONONONONONONONONONONONONONONONONONONONONONONONONONONONONONONONONONONONONONONONONONONONON
ONONONONONONONONONONONONONONONONONONONONONONONONONONONONONONONONONONONONONONONONONONONONONONONONONONONONONONONONONONONON
ONONONONONONONONONONONONONONONONONONONONONONONONONONONONONONONONONONONONONONONONONONONONONONONONONONONONONONONONONONONON
ONONONONONONONONONONONONONONONONONONONONONONONONONONONONONONONONONONONONONONONONONONONONONONONONONONONONONONONONONONONON
ONONONONONONONONONONONONONONONONONONONONONONONONONONONONONONONONONONONONONONONONONONONONONONONONONONONONONONONONONONONON
ONONONONONONONONONONONONONONONONONONONONONONONONONONONONONONONONONONONONONONONONONONONONONONONONONONONONONONONONONONONON
ONONONONONONONONONONONONONONONONONONONONONONONONONONONONONONONONONONONONONONONONONONONONONONONONONONONONONONONONONONONON
ONONONONONONONONONONONONONONONONONONONONONONONONONONONONONONONONONONONONONONONONONONONONONONONONONONONONONONONONONONONON
ONONONONONONONONONONONONONONONONONONONONONONONONONONONONONONONONONONONONONONONONONONONONONONONONONONONONONONONONONONONON
ONONONONONONONONONONONONONONONONONONONONONONONONONONONONONONONONONONONONONONONONONONONONONONONONONONONONONONONONONONONON
ONONONONONONONONONONONONONONONONONONONONONONONONONONONONONONONONONONONONONONONONONONONONONONONONONONONONONONONONONONONON
ONONONONONONONONONONONONONONONONONONONONONONONONONONONONONONONONONONONONONONONONONONONONONONONONONONONONONONONONONONONON
ONONONONONONONONONONONONONONONONONONONONONONONONONONONONONONONONONONONONONONONONONONONONONONONONONONONONONONONONONONONON
ONONONONONONONONONONONONONONONONONONONONONONONONONONONONONONONONONONONONONONONONONONONONONONONONONONONONONONONONONONONON
ONONONONONONONONONONONONONONONONONONONONONONONONONONONONONONONONONONONONONONONONONONONONONONONONONONONONONONONONONONONON
ONONONONONONONONONONONONONONONONONONONONONONONONONONONONONONONONONONONONONONONONONONONONONONONONONONONONONONONONONONONON
ONONONONONONONONONONONONONONONONONONONONONONONONONONONONONONONONONONONONONONONONONONONONONONONONONONONONONONONONONONONON
ONONONONONONONONONONONONONONONONONONONONONONONONONONONONONONONONONONONONONONONONONONONONONONONONONONONONONONONONONONONON
ONONONONONONONONONONONONONONONONONONONONONONONONONONONONONONONONONONONONONONONONONONONONONONONONONONONONONONONONONONONON
ONONONONONONONONONONONONONONONONONONONONONONONONONONONONONJOOCJOsmJOONONONONONONONONONONONONONONONONONONONONONONONONONON
ONONONONONONONONONONONONONONONONONONONONONONONONONONONONONJOsmJOsmJOONONONONONONONONONONONONONONONONONONONONONONONONONON
ONONONONONONONONONONONONONONONONONONONONONONONONONONJOJOJOJOxHJOsmJOJOJOJOONONONONONONONONONONONONONONONONONONONONONONON
ONONONONONONONONONONONONONONONONONONONONONONONONONONJOojvwEKojojojEKTJojJOONONONONONONONONONONONONONONONONONONONONONONON
ONONONONONONONONONONONONONONONONONONONONONONONONONONJOojojMoojojojXbojojJOONONONONONONONONONONONONONONONONONONONONONONON
ONONONONONONONONONONONONONONONONONONONONONONONJOJOJOJOEKEKEKmCojlZEKEKEKJOJOONONJOONONONONONONONONONONONONONONONONONONON
ONONONONONONONONONONONONONONONONONONONJOkykyJOJOgHgHEKojojaDojojojAhojojEKdYONONJOONONONONONONONONONONONONONONONONONONON
ONONONONONONONONONONONONONONONONONONJOJOSiwPEKFadYdYEKojNcEKojENojEKTJojEKdYONONJOJOONONONONONONONONONONONONONONONONONON
ONONONONONONONONONONONONONONONONONONJOSiSiSiGLdYdYdYEKEKEKEKWjEKWjEKEKEKEKdYONdYzpJOJOJOONONONONONONONONONONONONONONONON
ONONONONONONONONONONONONONONONONONJOJOeRSiSiLmdYdYEKrRyzrRyzrRrRrRWHsAjeavEKdYdYdYuRlcMnONONONONONONONONONONONONONONONON
ONONONONONONONONONONONONONONONONONkySiSiSiSiGLdYKfEKlRrRrRrRAcrRrRIDIDIDIDEKdYdYdYIMlcMnONONONONONONONONONONONONONONONON
ONONONONONONONONONONONONONONONONONkySiSiSiwPEKdYdYETrRrRrRMPNIMPrRrRrRrRrRdcdYdYdYIMlcMnONONONONONONONONONONONONONONONON
ONONONONONONONONONONONONONONONONONkySiSiSiwPEKdYKfEKrRrRAcjlrRMPAcrRrRrRuBEKdYdYdYdYlcMnONONONONONONONONONONONONONONONON
ONONONONONONONONONONONONONONONONONkySiSiSiSiGLdYdYETrRrRrRMPMPMPrRrRrRrRrRdcdYdYdYdYlcMnONONONONONONONONONONONONONONONON
ONONONONONONONONONONONONONONONONONJOJOeRSiSiELdYKfEKlRrRrRrRAcrRrRrRrRrRrREKdYdYdYdYlcMnONONONONONONONONONONONONONONONON
ONONONONONONONONONONONONONONONONONONJOSiSiSiGLdYdYEKrRrRrReArRrReArRrReArREKdYdYdYJOJOJOONONONONONONONONONONONONONONONON
ONONONONONONONONONONONONONONONONONONJOJOSiwPEKdYdYdYEKOkOkhROkfEEKSFSFEKfeEKdYdYmbJOONONONONONONONONONONONONONONONONONON
ONONONONONONONONONONONONONONONONONONONJOkykyJOJOkZuNEKDODOByDODOEKIDIDIDIDEKGGxSJOONONONONONONONONONONONONONONONONONONON
ONONONONONONONONONONONONONONONONONONONONONONONJOJOJOJOatDODODODOEKjpIDIDWsJOGhGhJOONONONONONONONONONONONONONONONONONONON
ONONONONONONONONONONONONONONONONONONONONONONONONONONJOapDODODODOEKZmIDIDxAJOONONONONONONONONONONONONONONONONONONONONONON
ONONONONONONONONONONONONONONONONONONONONONONONONONONJOnJDOYHWIAuEKQmjVDlxGJOONONONONONONONONONONONONONONONONONONONONONON
ONONONONONONONONONONONONONONONONONONONONONONONONONONJOJOaQJOaQJOJOJOjgjgJOJOONONONONONONONONONONONONONONONONONONONONONON
ONONONONONONONONONONONONONONONONONONONONONONONONONONONONONONONONONONONONONONONONONONONONONONONONONONONONONONONONONONONON
ONONONONONONONONONONONONONONONONONONONONONONONONONONONONONONONONONONONONONONONONONONONONONONONONONONONONONONONONONONONON
ONONONONONONONONONONONONONONONONONONONONONONONONONONONONONONONONONONONONONONONONONONONONONONONONONONONONONONONONONONONON
ONONONONONONONONONONONONONONONONONONONONONONONONONONONONONONONONONONONONONONONONONONONONONONONONONONONONONONONONONONONON
ONONONONONONONONONONONONONONONONONONONONONONONONONONONONONONONONONONONONONONONONONONONONONONONONONONONONONONONONONONONON
ONONONONONONONONONONONONONONONONONONONONONONONONONONONONONONONONONONONONONONONONONONONONONONONONONONONONONONONONONONONON
ONONONONONONONONONONONONONONONONONONONONONONONONONONONONONONONONONONONONONONONONONONONONONONONONONONONONONONONONONONONON
ONONONONONONONONONONONONONONONONONONONONONONONONONONONONONONONONONONONONONONONONONONONONONONONONONONONONONONONONONONONON
ONONONONONONONONONONONONONONONONONONONONONONONONONONONONONONONONONONONONONONONONONONONONONONONONONONONONONONONONONONONON
ONONONONONONONONONONONONONONONONONONONONONONONONONONONONONONONONONONONONONONONONONONONONONONONONONONONONONONONONONONONON
ONONONONONONONONONONONONONONONONONONONONONONONONONONONONONONONONONONONONONONONONONONONONONONONONONONONONONONONONONONONON
ONONONONONONONONONONONONONONONONONONONONONONONONONONONONONONONONONONONONONONONONONONONONONONONONONONONONONONONONONONONON
ONONONONONONONONONONONONONONONONONONONONONONONONONONONONONONONONONONONONONONONONONONONONONONONONONONONONONONONONONONONON
ONONONONONONONONONONONONONONONONONONONONONONONONONONONONONONONONONONONONONONONONONONONONONONONONONONONONONONONONONONONON
ONONONONONONONONONONONONONONONONONONONONONONONONONONONONONONONONONONONONONONONONONONONONONONONONONONONONONONONONONONONON
ONONONONONONONONONONONONONONONONONONONONONONONONONONONONONONONONONONONONONONONONONONONONONONONONONONONONONONONONONONONON
"}
